{
  "!": "!",
  "\"": "\"",
  "#": "#",
  "$": "$",
  "%": "%",
  "&": "&",
  "'": "'",
  "(": "(",
  ")": ")",
  "*": "*",
  "+": "+",
  ",": ",",
  "-": "-",
  ".": ".",
  "/": "/",
  "0": "0",
  "1": "1",
  "2": "2",
  "3": "3",
  "4": "4",
  "5": "5",
  "6": "6",
  "7": "7",
  "8": "8",
  "9": "9",
  ":": ":",
  ";": ";",
  "<": "<",
  "=": "=",
  ">": ">",
  "?": "?",
  "@": "@",
  "A": "A",
  "B": "B",
  "C": "C",
  "D": "D",
  "E": "E",
  "F": "F",
  "G": "G",
  "H": "H",
  "I": "I",
  "J": "J",
  "K": "K",
  "L": "L",
  "M": "M",
  "N": "N",
  "O": "O",
  "P": "P",
  "Q": "Q",
  "R": "R",
  "S": "S",
  "T": "T",
  "U": "U",
  "V": "V",
  "W": "W",
  "X": "X",
  "Y": "Y",
  "Z": "Z",
  "[": "[",
  "\\": "\\",
  "]": "]",
  "^": "^",
  "_": "_",
  "`": "`",
  "a": "a",
  "b": "b",
  "c": "c",
  "d": "d",
  "e": "e",
  "f": "f",
  "g": "g",
  "h": "h",
  "i": "i",
  "j": "j",
  "k": "k",
  "l": "l",
  "m": "m",
  "n": "n",
  "o": "o",
  "p": "p",
  "q": "q",
  "r": "r",
  "s": "s",
  "t": "t",
  "u": "u",
  "v": "v",
  "w": "w",
  "x": "x",
  "y": "y",
  "z": "z",
  "{": "{",
  "|": "|",
  "}": "}",
  "~": "~",
  "": "അ",
  "‚": "ആ",
  "ƒ": "ഇ",
  "„": "ഉ",
  "…": "ഋ",
  "†": "എ",
  "‡": "ഏ",
  "ˆ": "ഒ",
  "‰": "ക",
  "Š": "ഖ",
  "‹": "ഗ",
  "Œ": "ഘ",
  "": "ങ",
  "": "ഛ",
  "": "ജ",
  "‘": "ഝ",
  "’": "ഞ",
  "“": "ട",
  "”": "ഠ",
  "•": "ഡ",
  "–": "ഢ",
  "—": "ണ",
  "˜": "ത",
  "™": "ഥ",
  "š": "ദ",
  "›": "ധ",
  "œ": "ന",
  "": "പ",
  "¡": "ബ",
  "¢": "ഭ",
  "£": "മ",
  "¤": "യ",
  "¥": "ര",
  "¦": "റ",
  "§": "ല",
  "¨": "ള",
  "©": "ഴ",
  "ª": "വ",
  "«": "ശ",
  "¬": "ഷ",
  "­": "സ",
  "®": "ഹ",
  "¯": "ാ",
  "°": "ി",
  "±": "ീ",
  "²": "ു",
  "³": "ൂ",
  "´": "ൃ",
  "µ": "െ",
  "¶": "േ",
  "·": "ൗ",
  "¸": "്",
  "¹": "ം",
  "º": "ഃ",
  "»": "്യ",
  "¼": "്വ",
  "½": "്ര",
  "¾": "ക്ക",
  "¿": "ക്ല",
  "À": "ക്ഷ",
  "Á": "ഗ്ഗ",
  "Â": "ഗ്ല",
  "Ã": "ങ്ക",
  "Ä": "ങ്ങ",
  "Å": "ച്ച",
  "Æ": "ഞ്ച",
  "Ç": "ഞ്ഞ",
  "È": "ട്ട",
  "É": "ൺ",
  "Ê": "ണ്ട",
  "Ë": "ണ്ണ",
  "Ì": "ത്ത",
  "Í": "ദ്ദ",
  "Î": "ദ്ധ",
  "Ï": "ൻ",
  "Ð": "ന്ത",
  "Ñ": "ന്ദ",
  "Ò": "ന്ന",
  "Ó": "ന്മ",
  "Ô": "പ്പ",
  "Õ": "പ്ല",
  "Ö": "ബ്ബ",
  "×": "ബ്ല",
  "Ø": "മ്പ",
  "Ù": "മ്മ",
  "Ú": "മ്ല",
  "Û": "യ്യ",
  "Ü": "ർ",
  "Ý": "റ്റ",
  "Þ": "ൽ",
  "ß": "ല്ല",
  "à": "ൾ",
  "á": "ള്ള",
  "â": "വ്വ",
  "ã": "ശ്ല",
  "ä": "ശ്ശ",
  "å": "സ്ല",
  "æ": "സ്സ",
  "ç": "ഹ്ല",
  "è": "സ്റ്റ",
  "é": "ഡ്ഡ",
  "ê": "ക്ട",
  "ë": "ബ്ധ",
  "ì": "ബ്ദ",
  "í": "ച്ഛ",
  "î": "ജ്ജ",
  "ï": "ണ്മ",
  "ð": "സ്ഥ",
  "ñ": "ന്ഥ",
  "ò": "ജ്ഞ",
  "ó": "ത്ഭ",
  "ô": "ഗ്മ",
  "õ": "ശ്ച",
  "ö": "ണ്ധ",
  "÷": "ത്മ",
  "ø": "ക്ത",
  "ù": "ഗ്ന",
  "ú": "ന്റ",
  "û": "ഷ്ട",
  "ý": "ഫ",
  "þ": "-"
}
