{
  "!": "!",
  "\"": "\"",
  "#": "#",
  "$": "$",
  "%": "%",
  "&": "&",
  "'": "'",
  "(": "(",
  ")": ")",
  "*": "*",
  "+": "+",
  ",": ",",
  "-": "-",
  ".": ".",
  "/": "/",
  "0": "0",
  "1": "1",
  "2": "2",
  "3": "3",
  "4": "4",
  "5": "5",
  "6": "6",
  "7": "7",
  "8": "8",
  "9": "9",
  ":": ":",
  ";": ";",
  "<": "<",
  "=": "=",
  ">": ">",
  "?": "?",
  "@": "@",
  "A": "A",
  "B": "B",
  "C": "C",
  "D": "D",
  "E": "E",
  "F": "F",
  "G": "G",
  "H": "H",
  "I": "I",
  "J": "J",
  "K": "K",
  "L": "L",
  "M": "M",
  "N": "N",
  "O": "O",
  "P": "P",
  "Q": "Q",
  "R": "R",
  "S": "S",
  "T": "T",
  "U": "U",
  "V": "V",
  "W": "W",
  "X": "X",
  "Y": "Y",
  "Z": "Z",
  "[": "[",
  "\\": "\\",
  "]": "]",
  "^": "^",
  "_": "_",
  "`": "[",
  "a": "\\",
  "b": "]",
  "c": "^",
  "d": "_",
  "e": "`",
  "f": "a",
  "g": "b",
  "h": "c",
  "i": "d",
  "j": "e",
  "k": "f",
  "l": "g",
  "m": "h",
  "n": "i",
  "o": "j",
  "p": "k",
  "q": "l",
  "r": "m",
  "s": "n",
  "t": "o",
  "u": "p",
  "v": "q",
  "w": "r",
  "x": "s",
  "y": "t",
  "z": "u",
  "{": "{",
  "|": "|",
  "}": "}",
  "~": "~",
  " ": "ണ്ട",
  "¡": "ഗ്ഗ",
  "¢": "ഭ",
  "£": "മ",
  "¤": "യ്യ",
  "¥": "ൃ",
  "§": "യ",
  "¨": "ഷ",
  "©": "ഴ",
  "ª": "്യ",
  "«": "ഞ്ഞ",
  "¬": "ഗ്ല",
  "®": "ള",
  "¯": "ക്ത",
  "°": "ബ",
  "±": "ീ",
  "´": "ശ",
  "µ": "െ",
  "¶": "റ",
  "·": "ള്ള",
  "¸": "പ",
  "º": "്വ",
  "»": "ട്ട",
  "¿": "ക്ഷ",
  "À": "ണ്ണ",
  "Á": "ഹ്ല",
  "Â": "സ്ല",
  "Ã": "ത്ത",
  "Å": "അ",
  "Æ": "ഹ",
  "Ç": "ആ",
  "È": "ഡ്ഡ",
  "É": "ഇ",
  "Ê": "സ്സ",
  "Ë": "സ്റ്റ",
  "Ì": "ച്ഛ",
  "Í": "ക്ട",
  "Î": "ബ്ധ",
  "Ï": "ബ്ദ",
  "Ñ": "ഉ",
  "Ò": "ന്ഥ",
  "Ó": "ജ്ജ",
  "Ô": "ണ്മ",
  "Õ": "ദ്ദ",
  "Ö": "ഋ",
  "Ø": "ാ",
  "Ù": "ഗ്മ",
  "Ú": "ജ്ഞ",
  "Û": "ത്ഭ",
  "Ü": "എ",
  "ß": "ല",
  "à": "ഒ",
  "á": "ഏ",
  "â": "ക",
  "ã": "ഗ",
  "ä": "ഖ",
  "å": "ഘ",
  "æ": "ക്ക",
  "ç": "ങ",
  "è": "ഛ",
  "é": "ച",
  "ê": "ജ",
  "ë": "ഝ",
  "ì": "ട",
  "í": "ഞ",
  "î": "ഠ",
  "ï": "ഡ",
  "ñ": "ഢ",
  "ò": "ത",
  "ó": "ണ",
  "ô": "ഥ",
  "õ": "ധ",
  "ö": "ദ",
  "÷": "ബ്ബ",
  "ø": "ക്ല",
  "ú": "ന",
  "ÿ": "മ്പ",
  "ı": "ശ്ച",
  "Œ": "ദ്ധ",
  "œ": "ൻ",
  "Ÿ": "മ്മ",
  "ƒ": "ങ്ങ",
  "ˆ": "ണ്ധ",
  "˘": "ഗ്ന",
  "˙": "ന്റ",
  "˚": "ഷ്ട",
  "˛": "-",
  "˜": "ത്മ",
  "˝": "ഫ",
  "π": "ം",
  "–": "ന്ത",
  "—": "ന്ദ",
  "‘": "പ്പ",
  "’": "പ്ല",
  "‚": "വ്വ",
  "“": "ന്ന",
  "”": "ന്മ",
  "„": "ശ്ല",
  "‡": "ൾ",
  "•": "ര",
  "…": "ൺ",
  "‰": "ശ്ശ",
  "‹": "ർ",
  "›": "റ്റ",
  "⁄": "മ്ല",
  "™": "വ",
  "Ω": "്ര",
  "∂": "േ",
  "∆": "ഞ്ച",
  "∏": "്",
  "∑": "ൗ",
  "√": "ങ്ക",
  "∞": "ി",
  "∫": "ഃ",
  "≈": "ച്ച",
  "≠": "സ",
  "≤": "ു",
  "≥": "ൂ",
  "◊": "ബ്ല",
  "ﬁ": "ൽ",
  "ﬂ": "ല്ല"
}
